############
#          #
#  1       #
#          #
#        2 #
#  X   O   #
############